Word	Suffix
facing	ing
italy	ly
spelling	ing
claiming	ing
bombing	ing
totally	ly
graduating	ing
consideration	tion
publishing	ing
suffering	ing
racing	ing
direction	tion
mainly	ly
shopping	ing
arbitration	tion
opening	ing
offering	ing
learning	ing
tradition	tion
implementation	tion
addition	tion
calling	ing
warring	ing
allowing	ing
missing	ing
fairly	ly
examination	tion
essentially	ly
working	ing
establishing	ing
increasing	ing
organization	tion
making	ing
formally	ly
writing	ing
remaining	ing
deletion	tion
forming	ing
running	ing
participating	ing
seeing	ing
reportedly	ly
nomination	tion
assuming	ing
qualifying	ing
collaboration	tion
mostly	ly
protection	tion
during	ing
traditionally	ly
friendly	ly
completely	ly
spamming	ing
referring	ing
construction	tion
hunting	ing
freely	ly
respectively	ly
wrestling	ing
competition	tion
solely	ly
connecting	ing
marketing	ing
possibly	ly
attempting	ing
commonly	ly
recently	ly
thinking	ing
broadcasting	ing
warning	ing
simultaneously	ly
thing	ing
slightly	ly
suggestion	tion
shortly	ly
finally	ly
directly	ly
extremely	ly
containing	ing
attacking	ing
expedition	tion
reaching	ing
easily	ly
newly	ly
outstanding	ing
asking	ing
breeding	ing
approximately	ly
collection	tion
fishing	ing
quickly	ly
investigation	tion
participation	tion
traveling	ing
occupation	tion
everything	ing
equally	ly
studying	ing
creating	ing
something	ing
congregation	tion
king	ing
initially	ly
identification	tion
subsequently	ly
officially	ly
formation	tion
being	ing
family	ly
recreation	tion
situation	tion
contribution	tion
kelly	ly
correctly	ly
attending	ing
beijing	ing
greatly	ly
landing	ing
planning	ing
searching	ing
speaking	ing
processing	ing
cutting	ing
basically	ly
acting	ing
surviving	ing
gradually	ly
literally	ly
helping	ing
promoting	ing
seriously	ly
creation	tion
serving	ing
personally	ly
usually	ly
programming	ing
normally	ly
aviation	tion
stating	ing
translation	tion
becoming	ing
necessarily	ly
morning	ing
saying	ing
string	ing
winning	ing
portion	tion
providing	ing
printing	ing
ranking	ing
completion	tion
having	ing
destruction	tion
automatically	ly
repeatedly	ly
annually	ly
closing	ing
raising	ing
instruction	tion
extensively	ly
designation	tion
primarily	ly
execution	tion
featuring	ing
removing	ing
waiting	ing
parking	ing
explanation	tion
function	tion
radiation	tion
talking	ing
existing	ing
likely	ly
wearing	ing
independently	ly
liberation	tion
edition	tion
failing	ing
voting	ing
unfortunately	ly
motion	tion
reputation	tion
sing	ing
transportation	tion
improving	ing
currently	ly
certainly	ly
specifically	ly
losing	ing
visiting	ing
corporation	tion
recording	ing
reduction	tion
requiring	ing
bring	ing
actively	ly
production	tion
resulting	ing
selection	tion
successfully	ly
operation	tion
federation	tion
blocking	ing
exactly	ly
publication	tion
killing	ing
fly	ly
presentation	tion
playing	ing
mining	ing
slowly	ly
filming	ing
exhibition	tion
relating	ing
adding	ing
appearing	ing
dating	ing
ultimately	ly
reception	tion
testing	ing
operating	ing
actually	ly
only	ly
taking	ing
significantly	ly
poorly	ly
adaptation	tion
definition	tion
posting	ing
drawing	ing
constitution	tion
location	tion
rating	ing
locally	ly
using	ing
finding	ing
largely	ly
education	tion
describing	ing
producing	ing
simply	ly
absolutely	ly
defeating	ing
moving	ing
holding	ing
truly	ly
immediately	ly
willing	ing
beginning	ing
widely	ly
fully	ly
compilation	tion
painting	ing
covering	ing
interaction	tion
breaking	ing
particularly	ly
population	tion
arriving	ing
association	tion
cooperation	tion
managing	ing
nation	tion
knowing	ing
especially	ly
feeling	ing
preparation	tion
joining	ing
transition	tion
option	tion
driving	ing
representation	tion
ongoing	ing
heading	ing
increasingly	ly
variation	tion
engineering	ing
distribution	tion
ending	ing
discussing	ing
distinction	tion
classification	tion
farming	ing
temporarily	ly
ruling	ing
recognition	tion
leading	ing
leaving	ing
reporting	ing
seeking	ing
contributing	ing
historically	ly
clothing	ing
definitely	ly
internationally	ly
carrying	ing
citation	tion
nothing	ing
promotion	tion
exception	tion
falling	ing
singing	ing
handling	ing
communication	tion
fighting	ing
scoring	ing
wedding	ing
generally	ly
monthly	ly
training	ing
burning	ing
starring	ing
introduction	tion
heavily	ly
living	ing
relation	tion
eventually	ly
animation	tion
conservation	tion
partly	ly
sporting	ing
spring	ing
coalition	tion
closely	ly
attention	tion
celebration	tion
representing	ing
presumably	ly
roughly	ly
growing	ing
billy	ly
turning	ing
bringing	ing
constantly	ly
listing	ing
imply	ly
linking	ing
trying	ing
giving	ing
founding	ing
finishing	ing
foundation	tion
restoration	tion
evening	ing
partially	ly
frequently	ly
intention	tion
starting	ing
depending	ing
surrounding	ing
legislation	tion
selling	ing
anything	ing
regarding	ing
holy	ly
concentration	tion
ring	ing
rising	ing
suddenly	ly
nearly	ly
convention	tion
early	ly
application	tion
additionally	ly
solution	tion
building	ing
exclusively	ly
section	tion
formerly	ly
entering	ing
citing	ing
supply	ly
apparently	ly
expanding	ing
ranging	ing
institution	tion
highly	ly
administration	tion
description	tion
competing	ing
information	tion
dealing	ing
inspiration	tion
apply	ly
swimming	ing
keeping	ing
meeting	ing
passing	ing
unlikely	ly
properly	ly
publicly	ly
virtually	ly
signing	ing
manufacturing	ing
revolution	tion
previously	ly
strongly	ly
jurisdiction	tion
returning	ing
advertising	ing
crossing	ing
position	tion
riding	ing
notably	ly
replacing	ing
trading	ing
involving	ing
belonging	ing
defending	ing
continuing	ing
shooting	ing
maintaining	ing
dancing	ing
setting	ing
according	ing
meaning	ing
merely	ly
organisation	tion
rarely	ly
reading	ing
coming	ing
resolution	tion
generation	tion
residing	ing
hearing	ing
flying	ing
violation	tion
showing	ing
following	ing
doing	ing
rapidly	ly
preceding	ing
watching	ing
assembly	ly
weekly	ly
occasionally	ly
corresponding	ing
clearly	ly
intersection	tion
sharing	ing
standing	ing
going	ing
interpretation	tion
navigation	tion
funding	ing
opposition	tion
considering	ing
including	ing
action	tion
fiction	tion
originally	ly
walking	ing
interesting	ing
really	ly
performing	ing
telling	ing
reducing	ing
drinking	ing
conversation	tion
consisting	ing
election	tion
getting	ing
editing	ing
changing	ing
rolling	ing
putting	ing
immigration	tion
combination	tion
spending	ing
probably	ly
condition	tion
touring	ing
causing	ing
coaching	ing
potentially	ly
looking	ing
junction	tion
similarly	ly
deleting	ing
composition	tion
supporting	ing
developing	ing
receiving	ing
completing	ing
briefly	ly
elevation	tion
station	tion
question	tion
concerning	ing
daily	ly
reaction	tion
connection	tion
effectively	ly
wing	ing
shipping	ing
regularly	ly
teaching	ing
mention	tion
housing	ing
understanding	ing
obviously	ly
placing	ing
evolution	tion
relatively	ly
july	ly
sitting	ing
entirely	ly
typically	ly
sending	ing
